{
    "name": "Level 2",
    "width": 26,
    "height": 20,
    "playerStart": {"x": 12, "y": 0},
    "items": [
        {"type": "gold", "x": 3, "y": 16},
        {"type": "gold", "x": 17, "y": 16},
        {"type": "key", "x": 8, "y": 16},
        {"type": "halfKey", "x": 22, "y": 16}
    ],
    "enemies": [
        {"type": "snake", "x": 8, "y": 8},
        {"type": "snake", "x": 16, "y": 12}
    ],
    "tiles": [
        "###########oooo###########",
        "###########oooo###########",
        "#........................#",
        "#........................#",
        "#........................#",
        "#.....#####====#####.....#",
        "#.....#............#.....#",
        "#.....#............#.....#",
        "#.....#............#.....#",
        "#.....#............#.....#",
        "#.....#............#.....#",
        "#.....#............#.....#",
        "#.....#............#.....#",
        "#.....#............#.....#",
        "#.....#............#.....#",
        "#.....#............#.....#",
        "#.....#............#.....#",
        "#.....#............#.....#",
        "#.....#............#.....#",
        "###########<<<<############"
    ]
     
}
