{
    "name": "Level 4",
    "width": 52,
    "height": 40,
    "playerStart": {"x": 0, "y": 4},
    "items": [
        {"type": "gun", "x": 25, "y": 6},
        {"type": "key", "x": 4, "y": 12},
        {"type": "gold", "x": 38, "y": 12},
        {"type": "halfKey", "x": 4.5, "y": 35}
    ],
    "enemies": [  
        {"type": "spikeBall", "x": 26, "y": 17},
        {"type": "snake", "x": 40, "y": 16},
        {"type": "zombie", "x": 30, "y": 24},
        {"type": "zombie", "x": 27, "y": 32.5},
        {"type": "zombie", "x": 30, "y": 30},
        {"type": "zombie", "x": 24, "y": 28},
        {"type": "zombie", "x": 22, "y": 33}
    ],
    "tiles": [
        "####################################################",
        "####################################################",
        "####################################################",
        "####################################################",
        "...................................................#",
        "...................................................#",
        "...................................................#",
        "...................................................#",
        "...................................................#",
        "##########################################.........#",
        "#.......#.......-..................=.....#.........#",
        "#.......#.......-..................=.....#.........#",
        "#.......#.......-..................=.....#.........#",
        "#.......#.......-..................=.....#.........#",
        "#...............#..................=.....#.........#",
        "#...............#..................#######.........#",
        "#...............#..................................#",
        "#...............#..................................#",
        "#...............#..................................#",
        "#...............#..................................#",
        "#################..................................#",
        "#..................................................#",
        "#..................................................#",
        "#..................................................#",
        "#..................................................#",
        "#..................................................#",
        "#..................................................#",
        "#..................................................#",
        "#..................................................#",
        "#..................................................#",
        "#..................................................#",
        "#..................................................#",
        "#..................................................#",
        "#........#.........................................#",
        "#........#.........................................#",
        "#........#.........................................#",
        "#........#.........................................#",
        "#........#.........................................#",
        "#........#.........................................#",
        "######################<<<<<<<<<#####################"
    ]
}
