{
    "name": "Level 3",
    "width": 26,
    "height": 20,
    "playerStart": {"x": 22.5, "y": 0},
    "items": [
        {"type": "gold", "x": 3, "y": 3},
        {"type": "key", "x": 22.5, "y": 12}
    ],
    "enemies": [
        {"type": "ghost", "x": 22.5, "y": 16}
        
    ],
    "tiles": [
        "#####################....#",
        "#####################....#",
        "#........................#",
        "#........................#",
        "#........................#",
        "##########...########....#",
        "#........#..........#....#",
        "#........#..........#....#",
        "#........#..........#....#",
        "#...#....#######....#....#",
        "#...#...............#....#",
        "#...#...............#....#",
        "#...#...............#....#",
        "#...#################....#",
        "#...........#............#",
        "#...........#............<",
        "#.....#.....#.....#......<",
        "#.....#...........#......<",
        "#.....#...........#......<",
        "##########################"
    ]
     
}
