{
  "name": "Level 1",
  "width": 26,
  "height": 20,
  "playerStart": { "x": 0, "y": 16 },
  "items": [
    { "type": "gold", "x": 10, "y": 3.5 },
    { "type": "key", "x": 21.5, "y": 16 }
  ],
  "tiles": [
    "##########################",
    "##########################",
    "#............#...........#",
    "#............#...........#",
    "#............#...........#",
    "#............#...........#",
    "#......#######....#......#",
    "#.................#......#",
    "#.................#......#",
    "#.................#......#",
    "#.................#......#",
    "#......#....#######......#",
    "#......#..........#......#",
    "#......#..........#......#",
    "#......#..........#......#",
    "o......#..........#......#",
    "o......#..........#......#",
    "o......#..........#......#",
    "o......#..........#......#",
    "###########<<<<###########"
  ]
}
